NO ./assets/textures/north_texture.xpm
F 220,100,0
WE ./assets/textures/west_texture.xpm
SO ./assets/textures/south_texture.xpm
C 225,30,0
EA ./assets/textures/east_texture.xpm
1111111
1000001
1011001
100N001
1111111
