NO ./assets/textures/north_texture.xpm
F 220,100,0
SO ./assets/textures/south_texture.xpm
WE ./assets/textures/west_texture.xpm
EA ./assets/textures/east_texture.xpm

C 225,30,0

1111111
1000001
1011001
1000001
111111N
