NO ./assets/textures/north_texture.xpm
SO ./assets/textures/south_texture.xpm
WE ./assets/textures/west_texture.xpm
EA ./assets/textures/east_texture.xpm
F 220,100,0
C 225,30,0

1111111
1000001
10 1001
100N001
1111111
